%%%%%%%%%%%%%%%%%%%%%%%%
%       %...          4%
% .      ...          2%
%1      .%.o..         %
%3      . .  .         %
%%%%%%%%%%%%%%%%%%%%%%%%
